#待校
#####常見助詞代詞副詞指示詞#####
的之
地之
得之
之之
#這庶	遮或適
#这庶	遮或適
他它
她它
祂它
個个
个个
咱朁
偺朁
怎乍
些此
#####訓讀#####
開豈	闓
开豈	闓
軵戎	𢫨
鼂朝	朝
癡台	佁
翨支	翅
擉昔	簎
纔才	才
硩啇	擿
弴周	雕
璏衛	衛
暖耎	㬉
煖耎	煗
篧爵	𥷮
厜差	嵯
沴戾	戾
魼枼	鰈
翵侯	翭
靦面	說文見聲，音腆
#####從古#####
塊凷	凷
块凷	凷
岸厂	干
䮗厂	干
草屮	早
花華	化
#####後起字·假借#####
已巳
乒兵
乓兵
乜乜
#####後起字·合音#####
甭甭
叵叵
#####後起字·擬聲#####
丼冘	石入井聲，古同井
飍休	擬聲似咻
䨻崩	擬聲
咩羋	擬聲
#####後起字·形/意#####
丟丟
卡卡
甩甩
矗矗
贇昷
赟昷
套套
凸凸	突
陡斗
吽吽	吼，又梵om音
靐朋
秤爯
凹凹
丳串
喆折	哲
嚞折	哲
娚男	喃，亦從甥嫐
閂全	栓
汆汆
岔叉
#####後起俗字#####
灵霝	靈（霝）
杰桀	傑（桀）
灶灶	竈（鼀）
尘尘	塵
歪歪	竵
尠鮮	鮮
衅衅	釁
岩岩	巖（嚴）
斌彬	彬
觕且	粗（且）
觔筋	筋
帘廉	簾（廉）
忐尋	憳（尋）
忑弋	忒（弋）
甦穌	蘇（穌）
皈歸	歸
晒麗	曬（麗）
䭮弗	髴（弗）
烼忽	䬍（忽）
飲酓	㱃（酓）
饮酓	㱃（酓）
凭仌	憑（仌）
浨林	漤（林）
庄壯	莊（壯）
壾莽	人名，三国时吴主孙休所创
呆豈	獃（豈）
#####後起省字訛字#####
找找	抓（爪），存疑
傻傻	誜（夋），存疑
楞夌	棱（夌）
愣夌	從楞
扯者	撦（者）
卤鹵	鹵，亦或西
#####後起不明#####
耍耍
戥等
躉屯
另另
乜乜
#####古字已不用被替代#####
姥老	姥
峔老	姥
#####附會#####
仉尚	掌
亍蜀	彳亍
甶弗	像鬼頭
䍜卓	罩，或同羅
刕利	姓
廴引	引
賣𧶠	𧶠
卖𧶠	𧶠
#####避免混淆#####
電电	申聲
电电	申聲
書書	者聲
书书	者聲
雪雪	彗聲，存疑
䨮雪	彗聲，存疑
關丱	聯聲
#关丱	聯聲
#####簡化字換聲旁（聲旁不同音的優先替換，其餘酌情）#####
#据豦	拮据，一般從據
肤膚	一般從膚
虮幾	密虮，其餘作蟣
确隺	犖确（一般作㪐㩿）、确瘠、磽确，其餘作確
柜貴	柜柳（一般作櫸柳 ），其餘作櫃
适啇	姓，一般從適
粮量	一般從糧
袜蔑	原意一種類似襪子的服裝，一般從襪
怜粦	怜悧（一般作伶俐），其餘作憐
迁䙴	一般從遷
药樂	一般從藥
圣聖	一般從聖
听聖	一般從聽
#洒麗	洒家，其餘作灑
栖妻	栖栖（又作棲棲），其餘作棲
蜡巤	一般從蠟
猎巤	一般從獵
腊巤	一般從臘
叶枼	一般從葉
#异異	一般從異
烟垔	烟熅，其餘作煙，或從菸
瓮邕	一般從甕
忧憂	一般從憂
邮郵	一般從憂郵
笋匀	一般從筍
担詹	一般從擔
胆詹	一般從膽
种重	一般從種
#冲重	沖洗意，其餘作衝
宁寧	一般從寧
柠寧	一般從檸
踪从	一般從蹤
#韵員	韵爲常見異體，同韻
洁㓞	一般從潔
体豊	一般從體
蚝高	一般從蠔
厘釐	異體，一般從釐
仇雔	姓氏，一般從讎
敌啇	一般從敵
胜朕	一般從勝